Basement########~##################################################
################-##################################################
################-#############-@-##################################
################-############-@-@-####-----------------############
################-###########@--P--@###-###############-############
################-##############-######-#############--@--##########
################-----*----#####-#!--@------!########@@@@@##########
################-########-#####-#-----------########--@--##########
################-########-#####-#-----"----@##########-############
################-#####@------"#-#----------------------############
################----!-----@-----------------#######################
######################@-------#-#----@-----!#######################
###############################-###################################
######-!-#-!-#-!-#-!-#-!-#####---#####-!-#-!-#-!-#-?-#-!-#-!-######
######---#---#---#---#---####@-@-@####---#---#---#---#---#---######
#-!@###-###-###-###-###-#####-----#####-###-###-###-###-###-###@--#
#+---------------------------------------------------------------+#
#-!@###-###-###-###-###-#####-----#####-###-###-###-###-###-###@--#
######---#---#---#---#---####-----####---#---#---#---#---#---######
######-!-#-!-#-!-#-!-#-!-####-----####-!-#-!-#-!-#-?-#-!-#-!-######
#############################-----#################################
#############################-----#################################
###############################=###################################